1 13 31
###############################
#      s* *   *    *  * * *   #
# # # #b# # #*#*# # # #*#*#*# #
#  x      *           *   * * #
# # # # # #*# # #*#*# # # # #*#
#f        x **  *  *          #
# # # # # # # # # #*# # # # # #
#*             1              #
# # # # #*# # # #*#*# # # # # #
#*   **  *                    #
# #*# # # # # # #*# # # # # # #
#   p       *   *  *          #
###############################