1 13 32
################################
#p     s* *   *    *  * * *3   #
# # # #b# # #*#*# # # #*#*#*#  #
#  x      *           *   * *  #
# # # # # #*# # #*#*# # # # #* #
#f        x **  *  *           #
# # # # # # # # # #*# # # # #  #
#*               1             #
# # # # #*# # # #*#*# # # # #  #
#*   **  *                     #
# #*# # # # # # #*# # # # # #  #
#           *   *  *           #
################################