1 13 31
###############################
#p     s* *   *    *  * * *2  #
# # # #b# # #*#*# # # #*#*#*# #
#  x      *           *   * * #
# # # # # #*# # #*#*# # # # #*#
#f        x **  *  *          #
# # # # # # # # # #*# # # # # #
#*     4 3                    #
# # # # #*# # # #*#*# # # # # #
#*   **  *                    #
# #*# # # # # # #*# # # # # # #
#           *   *  *          #
###############################