1 13 31
###############################
#p     s* *   *    *  * * *3 2#
# # # #b# # #*#*# # # #*#*#*# #
#  x      *           *   * * #
# # # # # #*# # #*#*# # # # #*#
#f        x **  *  *          #
# # # # # # # # # #*# # # # # #
#*               1            #
# # # # #*# # # #*#*# # # # # #
#*   **  *                    #
# #*# # # # # # #*# # # # # # #
#           *   *  *          #
###############################