1 13 31
###############################
#p     s* *   *    *  * * *3  #
# # # #b# # #*#*# # # #*#*#*# #
#  x       2          *   * * #
# # # # # #*# # #*#*# # # # #*#
#f        x **  *  *  3       #
# # # # # # # # # #*# # # # # #
#*        2     311111        #
# # # # #*# # # #*#*# # # # # #
#*   **  *    3        2      #
# #*# # # # # # #*# # # # # # #
#       2   *3  *  *          #
###############################