1 13 31
###############################
#p     s* *   *  2 *  * * *   #
# # # #b# # #*#*# # # #*#*#*# #
#  x    1             * 2 * * #
# # # # # #*# # #*#*# # # # #*#
#f        x **  *  *          #
# # # # # # # # # #*# # # # # #
#*                            #
# # # # #*# # # #*#*# # # # # #
#*   **  *                    #
# #*# # # # # # #*# # # # # # #
#           *   *  *          #
###############################