1 13 31
###############################
#p     s* *  1 * 2 *  * * *   #
# # # #b# # #*#*# # # #*#*#*# #
#  x    1         1   * 2 * * #
# # # # # #*# # #*#*# # # # #*#
#f       1 x **  *  *   1     #
# # # # # # # # # #*# # # # # #
#*               1            #
# # # # #*# # # #*#*# # # # # #
#*   1**  *   1               #
# #*# # # # # # #*# # # # # # #
#           *   *  *          #
###############################