1 13 31
###############################
#p     s* *   *    *  * * *   #
# # # #b# # #*#*# # # #*#*#*# #
#  x      *           *   * * #
# # # # # #*# # #*#*# # # # #*#
#f        x **  *  *          #
# # # # # # # # # #*# # # # # #
#*                            #
# # # # #*# # # #*#*# # # # # #
#*   **  *        4           #
# #*# # # # # # #*# # # # # # #
#           *   *  *          #
###############################